00 00 00 00 00 00 00 00 00 00 00 00 00 00
00 00 00 00 00 00 00 00 00 00 00 00 00 00
00 00 05 02 02 01 01 01 02 02 02 06 00 00
00 00 03 07 07 07 07 07 07 07 07 04 00 00
00 00 08 07 07 07 07 07 07 07 07 04 00 00
00 00 12 07 07 07 07 07 07 07 07 04 00 00
00 00 13 07 07 07 07 07 07 07 07 04 00 00
00 00 03 07 07 07 07 07 07 07 07 04 00 00
00 00 03 07 07 07 07 07 07 07 07 14 00 00
00 00 03 07 07 09 07 07 07 07 07 00 00 00
6 5