10 10 10 10 10 10 10 10 10 10 10 10 10 10
10 10 10 10 10 10 10 10 10 10 10 10 10 10
10 10 05 01 02 01 02 01 02 01 02 06 10 10
10 10 03 10 10 10 10 10 10 10 10 04 10 10
10 10 13 10 10 02 02 02 10 10 10 04 10 10
10 10 12 10 10 10 10 10 10 10 10 04 10 10
10 10 08 10 09 10 10 10 10 10 10 14 10 10
10 10 11 11 11 11 11 11 11 11 11 11 10 10
10 10 10 10 10 10 10 10 10 10 10 10 10 10
10 10 10 10 10 10 10 10 10 10 10 10 10 10
6 5